XXXXXXXX
X   XXXX
X   X  X
XX     X
XX XXXtX
X bXXXXX
Xa XXXXX
XXXXXXXX