XXXXXXXX
X     aX
Xt  b  X
X  tb  X
XXX X  X
XXXXXXXX
XXXXXXXX
XXXXXXXX