XXXXXXXXXX
XX  XXX  X
XX b  t  X
Xa  XXX  X
XbXXX  XXX
X XXX   XX
X XXXXX  X
X  XXXXX X
Xt XX    X
X   X    X
XX    X  X
XXXXXXXXXX