XXXXXXXXXXX
XXXXX    XX
XX       XX
XX    X   X
XX    Xb tX
XX    X   X
XX    XXXXX
XX  X    XX
XXa X b  XX
XX  X  t XX
XXXXXXXXXXX
XXXXXXXXXXX