XXXXXXXXXXX
Xa XX     X
X   X     X
X         X
XXX X  X  X
XX tXX Xb X
XX  X  X  X
XX  X bXXXX
XX   t XXXX
XXXXXXXXXXX