XXXXXXXXXXX
XX  X     X
XX        X
XXX X XXXXX
XX  X tb XX
Xa  X b  tX
X   XX    X
X   XXXXXXX
XX  XXXXXXX
XXXXXXXXXXX