XXXXXXXXXX
X tb XXXXX
X tX   XXX
X  X     X
XXbXX X  X
XXa    X X
XXXX     X
XXXXXXX  X
XXXXXXXXXX