XXXXXXXXX
XXXXXXXXX
XX   X  X
XXt  tbtX
XXXX  XXX
XXXXbb XX
XXXXa  XX
XXXXXXXXX