XXXXXXXX
XXXXa XX
XXXX bXX
XXXXb XX
XXX b  X
XX   ttX
XX t XXX
XXXXXXXX