XXXXXXXX
XXXXt XX
XX    XX
XX    XX
Xa   XXX
X  X XXX
XXXX XXX
X b    X
X      X
XXXXXXXX