XXXXXXXXX
XX tXXXXX
XX tXXXXX
XXX XXXXX
XXX XXXXX
XabtX   X
X bb    X
X       X
XXXXXXXXX