XXXXXXXXX
XXXXXXXXX
XX   X  X
XXt  tbtX
XX     XX
XXXXbb  X
X   a   X
XXXXXXXXX