XXXXXXXXXXXXXX
XX   XXX     X
XX   XXX     X
XXXX XXXXX   X
XXXX   XXX XXX
XXXX   XXX  XX
Xa   XXXXX  XX
X     XX   XXX
X  X  X      X
X  X     X   X
X  XXX X XX  X
X  X   X     X
XXXXtb XXX   X
XXXXXXXXXXXXXX