XXXXXXXXXXXX
Xa        XX
X X X   X  X
X   X      X
X    XXXXXXX
X  X   X btX
X  X       X
XX XXXXX XXX
X     X   XX
X  X  X   XX
XXXX  XXXXXX
XXXXXXXXXXXX