XXXXXXXXXXX
XX      XXX
XXbbXXX XXX
XX  XXX XXX
XX  XXX   X
Xa   t    X
X   XXXX  X
XX        X
XXXXX     X
XXXXXt XXXX
XXXXXXXXXXX