XXXXXXXXXXX
XXXX  XXXXX
XX    XX  X
XX    XX  X
XXXX     tX
Xa    X X X
X b   X   X
XXXX     XX
XXXXXXXXXXX