XXXXXXXXXXX
XXXX     XX
XXX      XX
XXX   X   X
XXX  XXb tX
XX    X  XX
XX    XXXXX
XX  X    XX
Xa  X b  XX
X   X  t XX
X     XXXXX
XXXXXXXXXXX