XXXXXXXXXXXXXX
X  XXXX  X  XX
X     X      X
X  X     XX  X
X   XXX  XX XX
X        XX XX
X XX    XXX XX
X XXX XXXXX XX
X  X     XX XX
Xt X  X  XX XX
XX XXXXXXX  XX
XX    X    b X
XXXX      Xa X
XXXXXXXXXXXXXX