XXXXXXXXXXX
Xa XXX  XXX
X b XX   XX
XX  XX   XX
X   XX X  X
X X X     X
X   X  X XX
XX tXXX   X
X         X
X  X   X  X
XXXXXXXXXXX