XXXXXXXXX
XX tXXXXX
XX tXXXXX
XXX XXXXX
XXX XXXXX
XabtXXXXX
X bbXXXXX
X   XXXXX
XXXXXXXXX