XXXXXXXXXXXX
Xa XXXX t  X
X       Xb X
X  XXXX  t X
XXXX  X  XXX
XXXX  X   XX
XXXX  XX  XX
XXXXX     XX
XXXXX b   XX
XXXXX    XXX
XXXXXXXXXXXX