XXXXXXXX
XX   t X
Xab bX X
X b t  X
XXXXt  X
XXXXXXXX
XXXXXXXX
XXXXXXXX