XXXXXXXXXXX
XX       XX
XXbbX    XX
XX  XXX XXX
XX  XXX   X
Xa   t    X
X   XXXX  X
XX        X
X   X     X
XXXXXt  XXX
XXXXXXXXXXX