XXXXXXXXXXX
XXXXXXX   X
Xa XXtb   X
X      X  X
XX  XXXXXXX
XX    XXXXX
XXX   XXXXX
XXXX     tX
XXXXX XX  X
XXXX   XXXX
XXX   b   X
XXX   X   X
XXXXXXXXXXX