XXXXXXX
Xa XXXX
X b t X
X  X  X
XXX   X
XX    X
XX  XXX
XXXXXXX
XXXXXXX