XXXXXXXXX
XX tXXXXX
XX tXXXXX
XXX XXXXX
XXX XXXXX
XabtXXXXX
X bbX   X
X       X
XXXXXXXXX