XXXXXXXXXXX
Xa X  X  XX
X bX     XX
X  X      X
X   X X   X
X t   X   X
XX  XXXXXXX
X       XXX
X  Xt b XXX
XXXX    XXX
XXXXXXXXXXX