XXXXXXXXX
XXXX   XX
XXXX    X
XXXXXXX X
Xa     tX
X bX X  X
X  X    X
XXXXXXXXX