XXXXXXXXXXX
XXXXX    XX
XXXX     XX
XXXX  X   X
XXX  XXb tX
XX    X  XX
XX    XXXXX
XXX X    XX
Xa  X b  XX
X   X  t XX
X     XXXXX
XXXXXXXXXXX