XXXXXXXXXXXX
Xa XXXX   XX
X     X X XX
XX  X X   XX
X tXX  X  XX
X      XXb X
X  XX XX   X
XX X       X
X          X
X   XX     X
XXXXXXX  XXX
XXXXXXXXXXXX