XXXXXXXX
XXXXXtXX
XXXXat X
X   b  X
Xt b b X
XX   XXX
XXXXXXXX
XXXXXXXX
XXXXXXXX