XXXXXXXX
XXXXXt X
XXXXat X
X   b  X
Xt b b X
XX  XXXX
XXXXXXXX
XXXXXXXX
XXXXXXXX