XXXXXXXXX
Xa     XX
X    t  X
X b XX  X
XXX X   X
XXXbt   X
XXX   XXX
XXXX  XXX
XXXXXXXXX