XXXXXXXX
X  XXXXX
X  XXXXX
X tX   X
XX X   X
Xab   XX
X  XXXXX
XXXXXXXX