XXXXXXXXXXXX
XXX  XXXXt X
XXX  XXX   X
XXX  XXX b X
XX  X     XX
XX     XXXXX
X      XXXXX
X   XXXa XXX
X X Xt b XXX
X   X  XXXXX
XX     XXXXX
XXXXXXXXXXXX