XXXXXXXXX
X   XXXXX
Xt  b XXX
X      XX
XXXXX   X
XXa X   X
XXb X t X
X  XXX XX
X       X
X  X    X
XXXXXXXXX