XXXXXXXXXX
XX  XXX  X
XX  XXX  X
XXX b    X
XXX XX   X
XXX      X
XXX    X X
XXX bXt  X
XXX     tX
XXX  X XXX
Xa  XX XXX
X      XXX
XXXXXXXXXX