XXXXXXXXXX
XXXXX XXXX
Xa t     X
XX XX X  X
XX X     X
XX X    tX
XX XX X  X
XX    X  X
XX  bbX  X
XX       X
XXXXXXXXXX