XXXXXXXXX
XXXXXXXXX
XX   X  X
XXt  tbtX
XXX    XX
XXXXbb XX
XXX a   X
XXXXXXXXX