XXXXXXXXXX
XXXXa  XXX
XXXX     X
XXXX  Xb X
XXXXXX   X
XXXXXX   X
XXXXXX   X
X   XXX  X
X  b Xt  X
Xt X     X
XXXXXXXXXX