XXXXXXXXX
XXa     X
XX   t  X
XXXXX  XX
XXXX   XX
XXXX  bXX
XXXXX  XX
XXXXXXXXX
XXXXXXXXX