XXXXXXXXXXX
XXX      XX
XXX      XX
XX    X   X
XX   XXb tX
XX    X  XX
XX    XXXXX
XX  X    XX
Xa  X b  XX
X   X  t XX
X     XXXXX
XXXXXXXXXXX