XXXXXXXXXX
XabtXXXXXX
X   X    X
X XX     X
X        X
X   X    X
XXXXXXXXXX
XXXXXXXXXX