XXXXXXXXX
XXXXXa XX
XX   b XX
XX  X XXX
X  X    X
X       X
X  X  X X
X   X   X
Xt  X   X
XXXXXXXXX