XXXXXXXXXX
XXXXXXXXXX
XX    tXXX
XX      tX
XX X  X  X
XX     XXX
XXXX   XXX
Xab b  XXX
X      XXX
XXXXXXXXXX