XXXXXXXXXXX
XXXXXXX   X
Xa XXtb   X
X      X  X
XX     XXXX
XX     XXXX
XXX    XXXX
XXXX     tX
XXXXX XX  X
XXXX    XXX
XXX   b   X
XXX   X   X
XXXXXXXXXXX