XXXXXX
XXXXXX
X  XXX
X  XXX
X b tX
XXa  X
XXXXXX
XXXXXX