XXXXXXXXXXX
XX       XX
XX       XX
XX    X   X
XX    Xb tX
XX    X   X
XX    XXXXX
XX  X    XX
Xa  X b  XX
X   X  t XX
XXXXXXXXXXX
XXXXXXXXXXX