XXXXXXXXXX
Xat   XXXX
X  Xb X  X
XXXX  X  X
XX  X X  X
XX      XX
XX  X  XXX
XX  XX   X
XX       X
XXX tb XXX
XXXX  XXXX
XXXXXXXXXX