XXXXXXXXXXXXXXX
Xat   XXXXXXXXX
X b b XX    XXX
XXXX         XX
XXXXXXXX  X  XX
X  XXXXX     XX
X   XXX     XXX
XXX X     XXXXX
XX          XXX
XX  X X  Xt  XX
X   X X       X
X   X X       X
X XXX X   XXX X
X     XXX     X
XXXXXXXXXXXXXXX