XXXXXXXXXXX
XX    XXXXX
Xa     b XX
X  X  XX XX
XXXX XX  XX
X  X XX XXX
X  X XX  XX
X    XXX  X
X    t    X
XXXX t b XX
XXXXXXXXXXX