XXXXXXXX
XX   XXX
XabtbXXX
X  X XXX
XXX tXXX
XXX  XXX
XXX  XXX
XXXXXXXX