XXXXXXXXXXXX
X   XXXXa XX
X   X   b XX
XXX X X  XXX
X      Xt  X
X  XX  X   X
X  XXXXXXXXX
X          X
X     X    X
XXXXXXXXXXXX