XXXXXXXXX
XX    XXX
XX    XXX
XXXX   XX
Xa     XX
X  b X  X
X  X    X
X tX   XX
XXXXXXXXX