XXXXXXXXX
Xa XXXXXX
X     XXX
XX XXbXXX
XX  X   X
X       X
Xt  X bXX
X t    XX
XXXXXXXXX