XXXXXXXXXX
XXXXXXX  X
XXXXXXX  X
XXXXXXX tX
XXXXatXbbX
XXXX bt  X
XXXX  XXXX
XXXXXXXXXX