XXXXXXXXX
XX   t XX
XX     XX
XXXX  XXX
XXXXX XXX
XX bab  X
XX  X   X
X     XtX
X       X
X  XX   X
XXXXXXXXX