XXXXXXX
XXXXXXX
X  XXXX
X  tXXX
X b baX
X t btX
X  XXXX
XXXXXXX