XXXXXXXXX
XXXXa  XX
XXXXtbbXX
XXXXXXtXX
XXXX    X
XXXX b  X
XXXXXXt X
XXXXXXXXX
XXXXXXXXX