XXXXXXXX
XXXX  XX
XXat  XX
XX     X
XX X   X
XX b X X
XXXX   X
XXXXXXXX