XXXXXXXXXXXX
XX  t X   XX
X   b X   XX
Xt  XXXX  XX
XXbXXXX  XXX
XXa   X  XXX
XXXX  X XXXX
XXX        X
XXX   X    X
XXXXXXXXXXXX