XXXXXXXXXX
X btXXXXXX
X   X  t X
X XXa    X
X   b    X
X   X    X
XXXXXXXXXX
XXXXXXXXXX