XXXXXXXXXXX
X   XXXXXXX
X X X  XXXX
X   X  XXXX
XX  XX Xa X
XXX     b X
XX     X  X
XX  XX XXXX
XX     XXXX
XX      t X
XXXXXXX   X
XXXXXXXXXXX