XXXXXXXXX
XXXXXXXXX
Xa tX  XX
X b    XX
XX XX  tX
X b X   X
X      XX
XXXXXXXXX