XXXXXXXXXXX
Xat  XXX  X
X bX  XX  X
X  X  XX  X
XXX       X
XX   X    X
XX      XXX
X   XX XXXX
X      XXXX
XXXXXXXXXXX