XXXXXXX
XXX   X
XX  t X
XXb XXX
Xa  XXX
X X XXX
X   XXX
XXXXXXX