XXXXXXX
Xt b aX
X tb  X
XX X  X
XXXXXXX
XXXXXXX
XXXXXXX